111111111111111111111111111111111111111
1P000001000C111C000C1C01000100000000001
111111010111000111101001010100000000101
1000000100000100000C110001010000000C101
101111010000010000001010010100011111101
1000C10101111C0000001001C10100000000101
100111010000010000001001110100000000101
1000011111000100000C1000C10100000000101
100000000100010000001001100111110000101
111111110100010000001001000100000000101
100000000111010000001001000100000000101
1010111111C1010000001001000111011111101
1010000000010100000C1001000100000000101
101111111111010000001010000010000000101
10000000000001C0000000C00000000000001E1
111111111111111111111111111111111111111