111111111
10PE00001
1000C0001
100000E01
111111111