111111111
10P000001
100C01111
100001E01
111111111