    11   11
   1CC1 1CC1
  1C00C1C00C1
   1C0P0E0C1
    1C000C1
     1C0C1
      1C1
       1