111111111
10P000001
1000C0000
100000E01
111111111