111111111
10P000001
1000C0001
100000001
111111111