111111111
10P000001
100C0C001
100000E01
111111111