111111111
10P000001
0000C0001
100000E01
111111111