111101111
10P000001
1000C0001
100000E01
111111111