11111111
10000001
10000001
10P0CE01
10000001
10000001
10000001
11111111