111111111
10P000001
1000C0001
10000PE01
111111111