111111111
1CPCCCCC1
1CCCCCCC1
1CCCCCEC1
111111111